box	10	0	0
box	11	0	0
box	12	0	0
box	20	0	0
box	21	0	0
box	22	0	0
box	23	0	0
box	32	0	0
box	31	1	0
box	26	0	1
box	19	0	1
box	12	0	1
