box	 7	0	0
box	17	0	0
box	27	0	0
box	25	0	1
box	25	1	1
box	10	0	1
box	10	1	1
box	10	2	1
