box	10	0	0
box	10	1	0
box	11	0	0
box	11	1	0
box	20	0	0
box	20	1	0
box	20	5	0
box	30	0	0
box	30	1	0
box	30	2	0
box	30	5	0
box	11	0	1
box	11	1	1
box	5	0	1
box	12	4	1
box	25	1	1
box	24	1	1
box	21	1	1
box	21	0	1
