box	8	0	0
box	9	0	0
box	10	0	0
box	14	1	0
box	15	1	0
box	16	1	0
box	17	1	0
box	18	1	0
box	19	1	0
box	27	1	0
box	27	2	0
box	27	3	0
box	27	4	0
box	32	0	0
box	32	1	0
box	25	4	1
box	25	0	1
box	15	4	1
box	15	0	1
box	5	0	1
box	5	4	1
