box	8	0	0
box	9	0	0
box	10	1	0
box	20	0	0
box	19	3	0
box	34	0	0
box	35	3	0
box	25	0	1
box	21	3	1
box	17	0	1
box	13	3	1
box	9	0	1
